1  2  3  4  3  4  3  4  3  4  3  5  1  1  1  1  
1  2  3  4  3  4  3  4  3  4  3  5  1  1  1  1  
1  1  1  1  1  1  1  1  6  7  8  9  8  10  11  12  
12 
13  14  15  16  15  16  15  16  15  16  15  17  18  18  18  19  
13  14  15  16  15  16  15  16  15  16  15  17  18  18  18  18  
18  18  18  18  18  18  18  20  21  22  23  24  23  25  26  12  
12 
27  28  27  28  27  28  27  28  27  28  27  29  30  31  30  32  
27  28  27  28  27  28  27  28  27  28  27  29  30  31  30  31  
30  31  30  31  30  31  30  33  12  34  35  36  35  37  38  12  
12 
39  40  41  42  39  43  39  43  39  43  39  44  15  16  15  45  
39  40  41  42  39  43  39  43  39  43  39  44  15  16  15  16  
15  16  15  46  47  48  47  49  12  23  50  51  52  53  54  12  
12 
27  55  56  57  27  28  27  28  27  28  27  28  27  28  27  28  
27  55  56  57  27  28  27  28  27  28  27  28  27  28  27  28  
27  28  27  55  56  58  56  58  12  59  60  12  35  61  62  12  
12 
41  63  64  65  41  66  41  66  41  66  41  66  41  66  41  66  
41  63  64  65  41  66  41  66  41  66  41  66  41  66  41  66  
41  66  41  63  64  12  64  12  12  52  67  12  52  68  26  12  
12 
56  58  69  70  56  58  56  58  56  58  56  58  56  58  56  58  
56  58  69  70  56  58  56  58  56  58  56  58  56  58  56  58  
56  58  56  58  69  70  12  12  12  59  62  12  35  37  38  12  
12 
71  72  73  74  64  75  71  76  71  72  64  75  71  72  64  75  
71  72  73  74  64  75  71  76  71  72  64  75  71  72  64  12  
64  12  64  12  73  74  12  12  12  77  78  12  79  80  81  12  
12 
82  83  84  85  86  87  82  88  82  89  86  87  82  89  86  87  
82  83  84  85  86  87  82  88  82  89  86  87  82  89  86  86  
86  90  91  92  84  93  94  95  96  97  98  99  100  101  38  12  
12 
102  103  104  105  106  107  102  108  102  109  106  107  102  109  106  107  
102  103  104  105  106  107  102  108  102  109  106  107  102  109  106  106  
106  110  111  112  104  113  114  115  116  117  118  119  120  121  122  12  
12 
12  12  12  12  12  12  12  12  12  12  12  12  12  12  12  12  
12  12  12  12  12  12  12  12  12  12  12  12  12  12  12  12  
12  12  12  12  12  12  12  12  12  12  12  12  12  12  12  12  
12