1  1  2  3  2  3  2  3  2  3  2  3  1  1  1  1  
1  1  2  3  2  3  2  3  2  3  2  3  1  1  1  1  
1  1  1  1  1  1  1  1  4  5  6  7  6  7  8  9  
9 
10  11  12  13  12  13  12  13  12  13  12  13  14  14  14  14  
10  11  12  13  12  13  12  13  12  13  12  13  14  14  14  14  
14  14  14  14  14  14  14  14  15  16  17  18  17  18  19  9  
9 
20  21  20  21  20  21  20  21  20  21  20  21  22  23  22  23  
20  21  20  21  20  21  20  21  20  21  20  21  22  23  22  23  
22  23  22  23  22  23  22  23  9  24  25  26  25  26  27  9  
9 
28  29  30  31  28  29  28  29  28  29  28  29  12  13  12  13  
28  29  30  31  28  29  28  29  28  29  28  29  12  13  12  13  
12  13  12  13  32  33  32  33  9  17  34  35  36  26  37  9  
9 
20  21  38  39  20  21  20  21  20  21  20  21  20  21  20  21  
20  21  38  39  20  21  20  21  20  21  20  21  20  21  20  21  
20  21  20  21  38  39  38  39  9  40  41  9  25  26  42  9  
9 
30  31  43  9  30  31  30  31  30  31  30  31  30  31  30  31  
30  31  43  9  30  31  30  31  30  31  30  31  30  31  30  31  
30  31  30  31  43  9  43  9  9  36  44  9  36  26  19  9  
9 
38  39  45  46  38  39  38  39  38  39  38  39  38  39  38  39  
38  39  45  46  38  39  38  39  38  39  38  39  38  39  38  39  
38  39  38  39  45  46  9  9  9  40  42  9  25  26  27  9  
9 
47  48  49  50  43  9  47  48  47  48  43  9  47  48  43  9  
47  48  49  50  43  9  47  48  47  48  43  9  47  48  43  9  
43  9  43  9  49  50  9  9  9  51  52  9  51  53  54  9  
9 
55  56  57  58  59  59  55  56  55  56  59  59  55  56  59  59  
55  56  57  58  59  59  55  56  55  56  59  59  55  56  59  59  
59  59  60  61  57  58  62  63  64  65  66  9  67  68  27  9  
9 
69  70  71  72  73  73  74  70  74  70  73  73  74  70  73  73  
74  70  71  72  73  73  74  70  75  76  77  77  78  76  77  77  
77  77  79  80  81  82  83  79  84  85  86  87  86  88  88  87  
9 
89  90  90  90  90  90  90  90  90  90  90  90  90  90  90  90  
90  90  90  90  90  90  90  90  91  92  92  92  92  92  92  92  
92  92  92  92  92  92  92  92  92  92  92  92  92  92  92  92  
9