1  2  3  4  5  6  1  2  1  2  3  4  5  6  1  2  
1  2  3  4  7  8  1  2  1  2  3  4  5  6  1  2  
9  10  3  4  5  6  9  10  1  2  1  2  11  12  13  12  
14  15  16  17  18  19  20  15  21  22  23  12  13  12  24  25  
26  15  27  25  26  15  27  25  26  15  27  25  26  15  28  12  
24  25  29  12  30  22  31  22  23  12  32  19  20  15  33  34  
35  36  37  37  37  37  38  15  39  37  37  37  37  37  37  37  
40  41  39  37  40  41  39  37  37  37  37  37  37  37  42  43  
44  12  13  12  45  46  47  48  49  50  51  46  52  53  54  50  
51  46  55  56  57  58  59  60  61  50  62  63  64  46  65  60  
61  50  62  63  64  46  65  60  61  50  66  67  68  53  69  70  
71 
72  73  3  4  74  75  76  77  78  79  3  4  74  75  76  77  
78  79  3  4  7  80  76  77  78  79  3  4  74  75  76  77  
72  73  3  4  74  75  81  81  78  79  78  79  82  83  84  83  
85  15  86  87  88  19  20  15  89  83  84  83  84  83  90  91  
92  15  93  19  20  15  93  19  20  15  93  19  20  15  89  83  
94  19  95  83  84  83  84  83  84  83  94  19  20  15  39  96  
97  36  37  98  99  37  38  100  39  37  101  102  101  102  101  102  
38  100  39  98  103  15  39  37  37  37  101  102  101  102  37  96  
95  83  90  91  104  46  105  106  107  106  108  46  109  110  111  106  
108  46  112  113  114  115  116  106  117  118  119  120  121  46  122  123  
124  118  119  120  121  46  122  123  124  118  125  126  127  110  128  70  
71 
129  130  3  4  131  132  9  10  1  2  3  4  131  132  9  10  
1  2  3  4  5  6  9  10  1  2  3  4  131  132  9  10  
129  130  3  4  131  132  81  81  1  2  1  2  11  12  13  12  
14  15  133  134  135  19  20  15  28  12  13  12  13  12  30  22  
136  15  93  19  20  15  93  19  20  15  93  19  20  15  28  12  
32  19  137  12  13  12  13  12  13  12  32  19  20  15  39  138  
139  36  140  141  37  37  40  41  39  37  37  37  37  37  37  37  
40  41  142  141  38  15  39  37  37  37  37  37  37  37  37  138  
143  12  30  22  144  46  145  50  146  50  51  46  109  110  147  50  
51  46  148  149  150  48  49  50  51  46  151  63  64  46  65  60  
152  46  151  63  64  46  65  60  152  46  55  56  153  110  154  70  
71 
78  79  3  4  155  156  81  81  78  79  3  4  74  75  81  81  
78  79  3  4  74  75  81  81  78  79  3  4  74  75  81  81  
78  79  3  4  74  75  81  81  78  79  78  79  157  158  159  160  
161  162  163  164  165  166  166  166  167  168  169  170  171  83  84  83  
85  15  93  19  20  15  93  19  20  15  93  19  20  15  172  173  
174  19  95  83  175  158  159  160  176  166  177  164  178  162  179  180  
97  36  37  37  37  37  181  162  179  37  37  37  182  183  182  183  
38  15  184  183  38  15  39  37  37  98  99  37  37  37  37  180  
177  164  165  166  185  186  187  188  189  190  191  46  109  110  111  106  
108  46  192  193  194  106  107  106  108  46  105  106  108  46  105  106  
108  46  105  106  108  46  195  196  197  46  192  193  198  110  199  200  
97 
1  2  3  4  201  202  81  81  1  2  3  4  131  132  81  81  
1  2  3  4  131  132  81  81  1  2  3  4  131  132  81  81  
1  2  3  4  131  132  81  81  1  2  1  2  203  204  205  206  
43  43  43  43  43  43  43  43  43  207  208  209  210  12  13  12  
14  15  93  19  20  15  93  19  20  15  93  19  20  15  27  25  
211  19  137  12  212  204  205  206  43  43  43  43  43  43  43  43  
43  43  43  43  43  43  43  43  213  37  37  37  214  215  214  215  
38  15  216  215  38  15  39  37  140  141  42  43  43  43  43  43  
43  43  43  43  217  218  218  219  220  221  222  46  109  110  147  50  
51  46  223  224  49  50  146  50  51  46  145  50  51  46  145  50  
51  46  145  50  51  46  52  53  225  46  223  224  226  110  199  227  
228 
78  79  3  4  78  79  81  81  78  79  3  4  155  156  81  81  
76  77  3  4  74  75  81  81  78  79  3  4  155  156  81  81  
78  79  3  4  74  75  81  81  229  230  231  232  233  205  234  235  
136  15  89  83  90  91  92  15  236  237  238  239  240  164  165  166  
20  15  93  19  20  15  93  19  20  15  93  19  20  15  241  91  
18  19  242  158  243  205  234  235  244  83  84  83  245  246  247  34  
35  36  182  183  182  183  38  15  39  37  248  249  250  37  182  183  
251  252  253  252  254  43  213  37  248  249  250  37  37  98  255  256  
257  258  259  83  260  118  261  262  263  264  265  186  266  267  268  186  
186  186  187  188  189  190  194  106  108  46  105  106  108  46  105  106  
108  46  105  106  108  46  269  115  270  46  271  272  273  274  275  276  
97 
1  2  3  4  1  2  81  81  1  2  3  4  201  202  81  81  
9  10  3  4  131  132  81  81  1  2  3  4  201  202  81  81  
1  2  3  4  131  132  81  81  277  231  278  279  280  43  281  282  
85  15  28  12  30  22  136  15  283  284  285  43  43  43  43  43  
286  15  93  19  20  15  93  19  20  15  93  19  20  15  21  22  
135  19  287  204  205  288  289  282  290  12  13  12  14  15  33  34  
35  36  214  215  214  215  38  15  291  43  43  292  293  294  295  215  
296  297  297  297  298  246  299  43  43  292  293  294  300  141  301  256  
302  17  303  12  45  46  304  58  305  218  218  218  218  218  218  218  
218  218  218  219  220  221  306  50  51  46  145  50  51  46  145  50  
51  46  145  50  51  46  47  48  307  46  308  309  310  311  218  218  
312 
78  79  3  4  78  79  81  81  76  77  3  4  78  79  81  81  
72  73  3  4  155  156  81  81  78  79  3  4  78  79  81  81  
72  73  3  4  155  156  229  230  313  278  314  315  316  173  317  83  
85  15  89  83  84  83  85  15  89  83  85  15  172  173  318  173  
319  15  93  19  20  15  93  19  20  15  93  19  20  15  172  173  
320  158  243  205  234  235  321  173  317  83  84  83  85  15  322  34  
35  36  37  37  37  37  38  100  184  183  38  15  323  324  250  37  
251  252  253  252  325  100  184  183  38  15  323  324  250  37  301  256  
326  87  171  83  327  46  105  106  328  196  197  46  269  115  270  46  
269  115  329  262  263  220  330  190  191  46  105  106  108  46  105  106  
108  46  105  106  108  46  105  106  108  46  331  310  332  333  334  70  
71 
1  2  3  4  1  2  81  81  9  10  3  4  1  2  81  81  
129  130  3  4  201  202  81  81  1  2  3  4  1  2  81  81  
129  130  3  4  201  202  277  231  278  335  336  337  338  25  29  12  
14  15  28  12  13  12  14  15  28  12  14  15  27  25  339  25  
26  15  93  19  20  15  93  19  20  15  93  19  20  15  27  25  
340  204  205  288  289  282  341  25  29  12  13  12  14  15  33  34  
35  36  37  37  37  37  40  41  216  215  38  15  342  343  293  294  
344  297  297  297  345  41  216  215  38  15  342  343  293  294  346  256  
347  134  23  12  45  46  145  50  348  53  225  46  47  48  307  46  
47  48  349  58  350  351  220  221  222  46  145  50  51  46  145  50  
51  46  145  50  51  46  145  50  51  46  352  218  353  354  355  70  
71 
356  357  358  359  356  357  356  357  356  357  358  359  356  357  356  357  
356  357  358  359  356  357  356  357  356  357  358  359  356  357  356  357  
356  357  358  359  356  357  360  278  356  357  356  357  361  164  362  164  
178  162  163  164  362  164  178  162  163  164  178  162  163  164  362  164  
178  162  163  164  178  162  163  164  178  162  163  164  178  162  163  164  
363  205  364  164  362  164  362  164  362  164  362  164  178  162  365  366  
35  36  248  249  250  37  181  162  179  37  181  162  179  367  368  369  
251  252  253  252  370  162  371  249  372  162  179  367  368  369  373  256  
374  164  362  164  375  376  377  267  378  267  379  376  377  267  379  376  
377  267  378  267  378  267  380  264  381  376  377  267  379  376  377  267  
379  376  377  267  379  376  377  267  379  376  377  267  378  267  382  383  
71 
279  279  279  279  279  279  279  279  279  279  279  279  279  279  279  279  
279  279  279  279  279  279  279  279  279  279  279  279  279  279  279  279  
279  279  279  279  279  279  279  279  279  279  279  279  280  43  43  43  
43  43  43  43  43  43  43  43  43  43  43  43  43  43  43  43  
43  43  43  43  43  43  43  43  43  43  43  43  43  43  43  43  
43  43  43  43  43  43  43  43  43  43  43  43  43  43  43  43  
43  43  43  292  384  43  43  43  43  43  43  43  43  43  43  43  
385  297  297  297  254  43  43  292  384  43  43  43  43  43  43  43  
43  43  43  43  217  218  218  218  218  218  218  218  218  218  218  218  
218  218  218  218  218  218  218  218  218  218  218  218  218  218  218  218  
218  218  218  218  218  218  218  218  218  218  218  218  218  218  218  218  
312 
97  97  97  97  97  97  97  97  97  97  97  97  97  97  97  97  
97  97  97  97  97  97  97  97  97  97  97  97  97  97  97  97  
97  97  97  97  97  97  97  97  97  97  97  97  97  97  97  97  
97  97  97  97  97  97  97  97  97  97  97  97  97  97  97  97  
97  97  97  97  97  97  97  97  97  97  97  97  97  97  97  97  
97  97  97  97  97  97  97  97  97  97  97  97  97  97  97  97  
97  97  97  97  97  97  97  97  97  97  97  97  97  97  97  97  
97  97  97  97  97  97  97  97  97  97  97  97  97  97  97  97  
97  97  97  97  97  97  97  97  97  97  97  97  97  97  97  97  
97  97  97  97  97  97  97  97  97  97  97  97  97  97  97  97  
97  97  97  97  97  97  97  97  97  97  97  97  97  97  97  97  
97