1  2  3  4  5  6  1  2  6  6  6  6  1  2  6  6  
1  2  6  6  7  8  3  4  5  6  6  6  7  8  9  10  
6 
7  8  3  3  4  5  7  11  6  6  6  6  7  11  6  6  
7  8  6  6  7  8  3  3  4  5  6  6  7  8  9  10  
6 
7  8  3  3  3  4  12  11  6  6  6  6  12  11  6  6  
7  8  6  6  7  8  3  3  3  4  5  6  7  8  9  10  
6 
7  11  3  3  3  3  13  13  6  6  6  6  7  11  6  6  
7  8  6  6  7  8  3  3  3  3  4  5  7  8  9  10  
6 
12  11  3  3  3  3  1  2  6  6  6  6  12  11  6  6  
7  8  6  6  7  8  3  3  3  3  3  4  7  8  9  10  
6 
13  13  13  13  13  13  13  13  13  13  13  13  13  13  6  6  
13  13  6  6  13  13  13  13  13  13  13  13  13  13  9  10  
6 
1  2  14  15  14  15  1  2  16  17  14  15  1  2  6  6  
1  2  6  6  1  2  14  15  14  15  14  15  1  2  9  10  
6 
7  11  6  6  6  6  7  11  18  19  20  20  7  8  6  21  
7  8  6  21  7  8  20  20  6  21  6  6  7  8  13  13  
6 
12  11  6  6  6  6  12  11  6  6  20  20  7  8  22  23  
7  8  22  23  7  8  20  20  22  23  6  6  7  8  14  15  
6 
24  25  24  25  24  25  24  25  24  25  24  25  24  25  24  25  
24  25  24  25  24  25  24  25  24  25  24  25  13  13  24  25  
6 
26  27  26  27  26  27  26  27  26  27  26  27  26  27  26  27  
26  27  26  27  26  27  26  27  26  27  26  27  28  29  26  27  
30