1  2  3  4  5  6  1  2  1  2  3  4  5  6  1  2  
1  2  3  4  7  8  1  2  1  2  3  4  5  6  1  2  
9  10  3  4  5  6  9  10  1  2  1  2  1  2  1  2  
3  4  5  6  11  11  3  4  12  13  1  2  1  2  9  10  
3  4  9  10  3  4  9  10  3  4  9  10  3  4  1  2  
9  10  1  2  12  13  12  13  1  2  11  11  3  4  14  15  
15  16  16  16  16  16  3  4  16  16  16  16  16  16  16  16  
17  18  16  16  17  18  16  16  16  16  16  16  16  16  15  15  
1  2  1  2  3  4  12  13  1  2  3  4  9  10  1  2  
3  4  5  6  19  20  21  22  1  2  23  24  3  4  21  22  
1  2  23  24  3  4  21  22  1  2  7  8  9  10  14  15  
15 
25  26  3  4  27  28  29  30  31  32  3  4  27  28  29  30  
31  32  3  4  7  33  29  30  31  32  3  4  27  28  29  30  
25  26  3  4  27  28  11  11  31  32  31  32  31  32  31  32  
3  4  34  35  11  11  3  4  31  32  31  32  31  32  25  26  
3  4  11  11  3  4  11  11  3  4  11  11  3  4  31  32  
11  11  31  32  31  32  31  32  31  32  11  11  3  4  16  15  
15  16  16  36  16  16  3  18  16  16  37  16  37  16  37  16  
3  18  16  36  3  4  16  16  16  16  37  16  37  16  16  15  
31  32  25  26  3  4  31  32  31  32  3  4  11  11  31  32  
3  4  27  28  25  26  31  32  38  39  40  41  3  4  42  43  
38  39  40  41  3  4  42  43  38  39  7  33  11  11  44  15  
15 
12  13  3  4  45  46  9  10  1  2  3  4  45  46  9  10  
1  2  3  4  5  6  9  10  1  2  3  4  45  46  9  10  
12  13  3  4  45  46  11  11  1  2  1  2  1  2  1  2  
3  4  47  48  11  11  3  4  1  2  1  2  1  2  12  13  
3  4  11  11  3  4  11  11  3  4  11  11  3  4  1  2  
11  11  1  2  1  2  1  2  1  2  11  11  3  4  16  15  
15  16  49  50  16  16  17  18  16  16  16  16  16  16  16  16  
17  18  49  50  3  4  16  16  16  16  16  16  16  16  16  15  
1  2  12  13  3  4  1  2  1  2  3  4  11  11  1  2  
3  4  45  46  12  13  1  2  3  4  23  24  3  4  21  22  
3  4  23  24  3  4  21  22  3  4  5  6  11  11  14  15  
15 
31  32  3  4  34  35  11  11  31  32  3  4  27  28  11  11  
31  32  3  4  27  28  11  11  31  32  3  4  27  28  11  11  
31  32  3  4  27  28  11  11  31  32  31  32  51  52  53  54  
55  56  57  58  59  59  59  59  60  61  62  63  31  32  31  32  
3  4  11  11  3  4  11  11  3  4  11  11  3  4  29  30  
11  11  31  32  51  52  53  54  59  59  57  58  55  56  16  15  
15  16  16  16  16  16  55  56  16  16  16  16  64  65  64  65  
3  4  64  65  3  4  16  16  16  36  16  16  16  16  16  15  
57  58  59  59  59  59  60  61  62  63  3  4  11  11  31  32  
3  4  34  35  31  32  31  32  3  4  31  32  3  4  31  32  
3  4  31  32  3  4  29  30  3  4  34  35  11  11  16  15  
15 
1  2  3  4  47  48  11  11  1  2  3  4  45  46  11  11  
1  2  3  4  45  46  11  11  1  2  3  4  45  46  11  11  
1  2  3  4  45  46  11  11  1  2  1  2  66  53  67  15  
15  15  15  15  15  15  15  15  15  68  69  70  1  2  1  2  
3  4  11  11  3  4  11  11  3  4  11  11  3  4  9  10  
11  11  1  2  66  53  67  15  15  15  15  15  15  15  15  15  
15  15  15  15  15  15  15  15  16  16  16  16  15  71  15  71  
3  4  15  71  3  4  16  16  49  50  15  15  15  15  15  15  
15  15  15  15  15  15  15  68  69  70  3  4  11  11  1  2  
3  4  47  48  1  2  1  2  3  4  1  2  3  4  1  2  
3  4  1  2  3  4  9  10  3  4  47  48  11  11  16  15  
15 
31  32  3  4  31  32  11  11  31  32  3  4  34  35  11  11  
29  30  3  4  27  28  11  11  31  32  3  4  34  35  11  11  
31  32  3  4  27  28  11  11  51  52  53  54  72  67  73  74  
3  4  31  32  25  26  3  4  75  76  68  77  57  58  59  59  
3  4  11  11  3  4  11  11  3  4  11  11  3  4  25  26  
11  11  51  52  78  67  73  74  31  32  31  32  38  39  44  15  
15  16  64  65  64  65  3  4  16  16  59  79  16  16  64  65  
15  15  15  15  15  15  16  16  59  79  16  16  16  36  80  81  
7  33  31  32  38  39  75  76  68  77  59  59  57  58  59  59  
59  59  60  61  62  63  31  32  3  4  31  32  3  4  31  32  
3  4  31  32  3  4  25  26  3  4  51  52  53  54  16  15  
15 
1  2  3  4  1  2  11  11  1  2  3  4  47  48  11  11  
9  10  3  4  45  46  11  11  1  2  3  4  47  48  11  11  
1  2  3  4  45  46  11  11  66  53  67  15  15  15  82  83  
3  4  1  2  12  13  3  4  19  20  15  15  15  15  15  15  
3  4  11  11  3  4  11  11  3  4  11  11  3  4  12  13  
11  11  66  53  67  84  82  83  1  2  1  2  3  4  14  15  
15  16  15  71  15  71  3  4  15  15  15  15  85  86  15  71  
15  15  15  15  38  39  15  15  15  15  85  86  49  50  80  81  
5  6  1  2  3  4  19  20  15  15  15  15  15  15  15  15  
15  15  15  68  69  70  1  2  3  4  1  2  3  4  1  2  
3  4  1  2  3  4  12  13  3  4  66  53  67  15  15  15  
15 
31  32  3  4  31  32  11  11  29  30  3  4  31  32  11  11  
25  26  3  4  34  35  11  11  31  32  3  4  31  32  11  11  
25  26  3  4  34  35  51  52  78  67  73  74  29  30  31  32  
3  4  31  32  31  32  3  4  31  32  3  4  29  30  29  30  
3  4  11  11  3  4  11  11  3  4  11  11  3  4  29  30  
51  52  78  67  73  74  29  30  31  32  31  32  3  4  44  15  
15  16  16  16  16  16  3  18  64  65  3  4  68  79  16  16  
15  15  15  15  3  18  64  65  3  4  68  79  16  16  80  81  
34  35  31  32  3  4  31  32  29  30  3  4  25  26  3  4  
25  26  75  76  68  69  62  63  3  4  31  32  3  4  31  32  
3  4  31  32  3  4  31  32  3  4  72  67  73  74  44  15  
15 
1  2  3  4  1  2  11  11  9  10  3  4  1  2  11  11  
12  13  3  4  47  48  11  11  1  2  3  4  1  2  11  11  
12  13  3  4  47  48  66  53  67  84  82  83  9  10  1  2  
3  4  1  2  1  2  3  4  1  2  3  4  9  10  9  10  
3  4  11  11  3  4  11  11  3  4  11  11  3  4  9  10  
66  53  67  84  82  83  9  10  1  2  1  2  3  4  14  15  
15  16  16  16  16  16  17  18  15  71  3  4  87  68  85  86  
15  15  15  15  17  18  15  71  3  4  87  68  85  86  80  81  
47  48  1  2  3  4  1  2  9  10  3  4  12  13  3  4  
12  13  19  20  88  68  69  70  3  4  1  2  3  4  1  2  
3  4  1  2  3  4  1  2  3  4  15  15  82  83  14  15  
15 
57  58  55  56  57  58  57  58  57  58  55  56  57  58  57  58  
57  58  55  56  57  58  57  58  57  58  55  56  57  58  57  58  
57  58  55  56  57  58  72  67  57  58  57  58  57  58  57  58  
55  56  57  58  57  58  55  56  57  58  55  56  57  58  57  58  
55  56  57  58  55  56  57  58  55  56  57  58  55  56  57  58  
72  67  57  58  57  58  57  58  57  58  57  58  55  56  89  15  
15  16  59  79  16  16  55  56  16  16  55  56  16  90  68  91  
15  15  15  15  55  56  59  79  55  56  16  90  68  91  92  81  
57  58  57  58  55  56  57  58  57  58  55  56  57  58  55  56  
57  58  57  58  57  58  68  77  55  56  57  58  55  56  57  58  
55  56  57  58  55  56  57  58  55  56  57  58  57  58  89  15  
15 
15  15  15  15  15  15  15  15  15  15  15  15  15  15  15  15  
15  15  15  15  15  15  15  15  15  15  15  15  15  15  15  15  
15  15  15  15  15  15  15  15  15  15  15  15  15  15  15  15  
15  15  15  15  15  15  15  15  15  15  15  15  15  15  15  15  
15  15  15  15  15  15  15  15  15  15  15  15  15  15  15  15  
15  15  15  15  15  15  15  15  15  15  15  15  15  15  15  15  
15  15  15  93  15  15  15  15  15  15  15  15  15  15  15  15  
15  15  15  15  15  15  15  15  15  15  15  15  15  15  15  15  
15  15  15  15  15  15  15  15  15  15  15  15  15  15  15  15  
15  15  15  15  15  15  15  15  15  15  15  15  15  15  15  15  
15  15  15  15  15  15  15  15  15  15  15  15  15  15  15  15  
15