1  2  3  4  5  6  1  2  7  8  8  8  1  2  7  8  
1  2  7  8  9  10  11  4  5  6  8  8  9  10  12  13  
8 
9  10  11  14  4  5  15  16  17  8  8  8  9  16  17  8  
9  10  17  8  9  10  11  14  4  5  6  8  9  10  12  13  
8 
9  10  11  14  14  4  18  19  17  8  8  8  18  19  17  8  
9  10  17  8  9  10  11  14  14  4  5  6  9  10  12  13  
8 
9  16  11  14  14  14  20  8  8  8  8  8  9  16  17  8  
9  10  17  8  9  10  11  14  14  14  4  5  15  10  12  13  
8 
18  19  11  14  14  14  21  22  7  8  8  8  18  19  17  8  
9  10  17  8  9  10  11  14  14  14  14  4  9  10  12  13  
8 
8  8  8  8  8  8  8  8  8  8  8  8  8  8  8  8  
8  8  8  8  8  8  8  8  8  8  8  8  8  23  12  13  
8 
1  2  24  25  26  25  27  2  28  29  30  25  27  2  7  8  
1  2  7  8  1  2  24  25  26  25  26  25  27  31  12  13  
8 
9  16  17  8  8  8  9  16  32  33  34  35  36  10  17  37  
9  10  17  37  9  10  38  35  39  37  8  8  9  10  17  8  
8 
18  19  17  8  8  8  18  19  17  8  34  35  36  10  40  41  
42  10  40  41  42  10  38  35  43  41  44  8  9  10  45  25  
46 
47  48  49  48  49  48  49  48  49  48  49  48  49  48  49  48  
49  48  49  48  49  48  49  48  49  48  49  48  50  8  47  48  
50 
51  52  53  52  53  52  53  52  53  52  53  52  53  52  53  52  
53  52  53  52  53  52  53  52  53  52  53  52  54  2  55  52  
56