1  1  1  1  1  1  1  1  1  1  1  1  1  1  1  1  
1  1  1  1  1  1  1  1  1  1  1  1  1  1  1  1  
1  1  1  1  1  1  1  1  1  1  1  1  1  1  1  1  
1  1  1  1  1  1  1  1  1  1  1  1  1  1  1  1  
1  1  1  1  1  1  1  1  1  1  1  1  1  1  1  1  
1  1  1  1  1  1  1  1  1  1  1  1  1  1  1  1  
1  1  1  1  1  1  1  1  1  1  1  1  1  1  1  1  
1  1  1  1  1  1  1  1  1  1  1  1  1  1  1  1  
1  1  1  1  1  1  1  1  1  1  1  1  1  1  1  1  
1  1  1  1  1  1  1  1  1  1  1  1  1  1  1  1  
1  1  1  1  1  1  1  1  1  1  1  1  1  1  1  1
 
2  3  4  5  6  7  2  3  2  3  4  5  6  7  2  3  
2  3  4  5  8  9  2  3  2  3  4  5  6  7  2  3  
10  11  4  5  6  7  10  11  2  3  2  3  2  3  2  3  
4  5  6  7  12  12  4  5  13  14  2  3  2  3  10  11  
4  5  10  11  4  5  10  11  4  5  10  11  4  5  2  3  
10  11  2  3  13  14  13  14  2  3  12  12  4  5  15  1  
1  16  16  16  16  16  4  5  16  16  16  16  16  16  16  16  
17  18  16  16  17  18  16  16  16  16  16  16  16  16  1  1  
2  3  2  3  4  5  13  14  2  3  4  5  10  11  2  3  
4  5  6  7  19  20  21  22  2  3  23  24  4  5  21  22  
2  3  23  24  4  5  21  22  2  3  8  9  10  11  15  1
 
25  26  4  5  27  28  29  30  31  32  4  5  27  28  29  30  
31  32  4  5  8  33  29  30  31  32  4  5  27  28  29  30  
25  26  4  5  27  28  12  12  31  32  31  32  31  32  31  32  
4  5  34  35  12  12  4  5  31  32  31  32  31  32  25  26  
4  5  12  12  4  5  12  12  4  5  12  12  4  5  31  32  
12  12  31  32  31  32  31  32  31  32  12  12  4  5  16  1  
1  16  16  36  16  16  4  18  16  16  37  16  37  16  37  16  
4  18  16  36  4  5  16  16  16  16  37  16  37  16  16  1  
31  32  25  26  4  5  31  32  31  32  4  5  12  12  31  32  
4  5  27  28  25  26  31  32  38  39  40  41  4  5  42  43  
38  39  40  41  4  5  42  43  38  39  8  33  12  12  44  1
 
13  14  4  5  45  46  10  11  2  3  4  5  45  46  10  11  
2  3  4  5  6  7  10  11  2  3  4  5  45  46  10  11  
13  14  4  5  45  46  12  12  2  3  2  3  2  3  2  3  
4  5  47  48  12  12  4  5  2  3  2  3  2  3  13  14  
4  5  12  12  4  5  12  12  4  5  12  12  4  5  2  3  
12  12  2  3  2  3  2  3  2  3  12  12  4  5  16  1  
1  16  49  50  16  16  17  18  16  16  16  16  16  16  16  16  
17  18  49  50  4  5  16  16  16  16  16  16  16  16  16  1  
2  3  13  14  4  5  2  3  2  3  4  5  12  12  2  3  
4  5  45  46  13  14  2  3  4  5  23  24  4  5  21  22  
4  5  23  24  4  5  21  22  4  5  6  7  12  12  15  1
 
31  32  4  5  34  35  12  12  31  32  4  5  27  28  12  12  
31  32  4  5  27  28  12  12  31  32  4  5  27  28  12  12  
31  32  4  5  27  28  12  12  31  32  31  32  51  52  53  54  
55  56  57  58  59  59  59  59  60  61  62  63  31  32  31  32  
4  5  12  12  4  5  12  12  4  5  12  12  4  5  29  30  
12  12  31  32  51  52  53  54  59  59  57  58  55  56  16  1  
1  16  16  16  16  16  55  56  16  16  16  16  64  65  64  65  
4  5  64  65  4  5  16  16  16  36  16  16  16  16  16  1  
57  58  59  59  59  59  60  61  62  63  4  5  12  12  31  32  
4  5  34  35  31  32  31  32  4  5  31  32  4  5  31  32  
4  5  31  32  4  5  29  30  4  5  34  35  12  12  16  1
 
2  3  4  5  47  48  12  12  2  3  4  5  45  46  12  12  
2  3  4  5  45  46  12  12  2  3  4  5  45  46  12  12  
2  3  4  5  45  46  12  12  2  3  2  3  66  53  67  1  
1  1  1  1  1  1  1  1  1  68  69  70  2  3  2  3  
4  5  12  12  4  5  12  12  4  5  12  12  4  5  10  11  
12  12  2  3  66  53  67  1  1  1  1  1  1  1  1  1  
1  1  1  1  1  1  1  1  16  16  16  16  1  71  1  71  
4  5  1  71  4  5  16  16  49  50  1  1  1  1  1  1  
1  1  1  1  1  1  1  68  69  70  4  5  12  12  2  3  
4  5  47  48  2  3  2  3  4  5  2  3  4  5  2  3  
4  5  2  3  4  5  10  11  4  5  47  48  12  12  16  1
 
31  32  4  5  31  32  12  12  31  32  4  5  34  35  12  12  
29  30  4  5  27  28  12  12  31  32  4  5  34  35  12  12  
31  32  4  5  27  28  12  12  51  52  53  54  72  67  73  74  
4  5  31  32  25  26  4  5  75  76  68  77  57  58  59  59  
4  5  12  12  4  5  12  12  4  5  12  12  4  5  25  26  
12  12  51  52  78  67  73  74  31  32  31  32  38  39  44  1  
1  16  64  65  64  65  4  5  16  16  59  79  16  16  64  65  
1  1  1  1  1  1  16  16  59  79  16  16  16  36  80  81  
8  33  31  32  38  39  75  76  68  77  59  59  57  58  59  59  
59  59  60  61  62  63  31  32  4  5  31  32  4  5  31  32  
4  5  31  32  4  5  25  26  4  5  51  52  53  54  16  1
 
2  3  4  5  2  3  12  12  2  3  4  5  47  48  12  12  
10  11  4  5  45  46  12  12  2  3  4  5  47  48  12  12  
2  3  4  5  45  46  12  12  66  53  67  1  1  1  82  83  
4  5  2  3  13  14  4  5  19  20  1  1  1  1  1  1  
4  5  12  12  4  5  12  12  4  5  12  12  4  5  13  14  
12  12  66  53  67  84  82  83  2  3  2  3  4  5  15  1  
1  16  1  71  1  71  4  5  1  1  1  1  85  86  1  71  
1  1  1  1  38  39  1  1  1  1  85  86  49  50  80  81  
6  7  2  3  4  5  19  20  1  1  1  1  1  1  1  1  
1  1  1  68  69  70  2  3  4  5  2  3  4  5  2  3  
4  5  2  3  4  5  13  14  4  5  66  53  67  1  1  1
 
31  32  4  5  31  32  12  12  29  30  4  5  31  32  12  12  
25  26  4  5  34  35  12  12  31  32  4  5  31  32  12  12  
25  26  4  5  34  35  51  52  78  67  73  74  29  30  31  32  
4  5  31  32  31  32  4  5  31  32  4  5  29  30  29  30  
4  5  12  12  4  5  12  12  4  5  12  12  4  5  29  30  
51  52  78  67  73  74  29  30  31  32  31  32  4  5  44  1  
1  16  16  16  16  16  4  18  64  65  4  5  68  79  16  16  
1  1  1  1  4  18  64  65  4  5  68  79  16  16  80  81  
34  35  31  32  4  5  31  32  29  30  4  5  25  26  4  5  
25  26  75  76  68  69  62  63  4  5  31  32  4  5  31  32  
4  5  31  32  4  5  31  32  4  5  72  67  73  74  44  1
 
2  3  4  5  2  3  12  12  10  11  4  5  2  3  12  12  
13  14  4  5  47  48  12  12  2  3  4  5  2  3  12  12  
13  14  4  5  47  48  66  53  67  84  82  83  10  11  2  3  
4  5  2  3  2  3  4  5  2  3  4  5  10  11  10  11  
4  5  12  12  4  5  12  12  4  5  12  12  4  5  10  11  
66  53  67  84  82  83  10  11  2  3  2  3  4  5  15  1  
1  16  16  16  16  16  17  18  1  71  4  5  87  68  85  86  
1  1  1  1  17  18  1  71  4  5  87  68  85  86  80  81  
47  48  2  3  4  5  2  3  10  11  4  5  13  14  4  5  
13  14  19  20  88  68  69  70  4  5  2  3  4  5  2  3  
4  5  2  3  4  5  2  3  4  5  1  1  82  83  15  1
 
57  58  55  56  57  58  57  58  57  58  55  56  57  58  57  58  
57  58  55  56  57  58  57  58  57  58  55  56  57  58  57  58  
57  58  55  56  57  58  72  67  57  58  57  58  57  58  57  58  
55  56  57  58  57  58  55  56  57  58  55  56  57  58  57  58  
55  56  57  58  55  56  57  58  55  56  57  58  55  56  57  58  
72  67  57  58  57  58  57  58  57  58  57  58  55  56  89  1  
1  16  59  79  16  16  55  56  16  16  55  56  16  90  68  91  
1  1  1  1  55  56  59  79  55  56  16  90  68  91  92  81  
57  58  57  58  55  56  57  58  57  58  55  56  57  58  55  56  
57  58  57  58  57  58  68  77  55  56  57  58  55  56  57  58  
55  56  57  58  55  56  57  58  55  56  57  58  57  58  89  1
 
1  1  1  1  1  1  1  1  1  1  1  1  1  1  1  1  
1  1  1  1  1  1  1  1  1  1  1  1  1  1  1  1  
1  1  1  1  1  1  1  1  1  1  1  1  1  1  1  1  
1  1  1  1  1  1  1  1  1  1  1  1  1  1  1  1  
1  1  1  1  1  1  1  1  1  1  1  1  1  1  1  1  
1  1  1  1  1  1  1  1  1  1  1  1  1  1  1  1  
1  1  1  93  1  1  1  1  1  1  1  1  1  1  1  1  
1  1  1  1  1  1  1  1  1  1  1  1  1  1  1  1  
1  1  1  1  1  1  1  1  1  1  1  1  1  1  1  1  
1  1  1  1  1  1  1  1  1  1  1  1  1  1  1  1  
1  1  1  1  1  1  1  1  1  1  1  1  1  1  1  1
 
1  1  1  1  1  1  1  1  1  1  1  1  1  1  1  1  
1  1  1  1  1  1  1  1  1  1  1  1  1  1  1  1  
1  1  1  1  1  1  1  1  1  1  1  1  1  1  1  1  
1  1  1  1  1  1  1  1  1  1  1  1  1  1  1  1  
1  1  1  1  1  1  1  1  1  1  1  1  1  1  1  1  
1  1  1  1  1  1  1  1  1  1  1  1  1  1  1  1  
1  1  1  1  1  1  1  1  1  1  1  1  1  1  1  1  
1  1  1  1  1  1  1  1  1  1  1  1  1  1  1  1  
1  1  1  1  1  1  1  1  1  1  1  1  1  1  1  1  
1  1  1  1  1  1  1  1  1  1  1  1  1  1  1  1  
1  1  1  1  1  1  1  1  1  1  1  1  1  1  1  1
 
1  1  1  1  1  1  1  1  1  1  1  1  1  1  1  1  
1  1  1  1  1  1  1  1  1  1  1  1  1  1  1  1  
1  1  1  1  1  1  1  1  1  1  1  1  1  1  1  1  
1  1  1  1  1  1  1  1  1  1  1  1  1  1  1  1  
1  1  1  1  1  1  1  1  1  1  1  1  1  1  1  1  
1  1  1  1  1  1  1  1  1  1  1  1  1  1  1  1  
38  39  16  94  95  1  38  39  1  1  1  1  38  39  1  1  
38  39  1  1  4  5  16  94  95  1  1  1  4  5  80  81  
1  1  1  1  1  1  1  1  1  1  1  1  1  1  1  1  
1  1  1  1  1  1  1  1  1  1  1  1  1  1  1  1  
1  1  1  1  1  1  1  1  1  1  1  1  1  1  1  1
 
1  1  1  1  1  1  1  1  1  1  1  1  1  1  1  1  
1  1  1  1  1  1  1  1  1  1  1  1  1  1  1  1  
1  1  1  1  1  1  1  1  1  1  1  1  1  1  1  1  
1  1  1  1  1  1  1  1  1  1  1  1  1  1  1  1  
1  1  1  1  1  1  1  1  1  1  1  1  1  1  1  1  
1  1  1  1  1  1  1  1  1  1  1  1  1  1  1  1  
4  5  16  16  94  95  4  18  1  1  1  1  4  18  1  1  
4  5  1  1  4  5  16  16  94  95  1  1  4  5  80  81  
1  1  1  1  1  1  1  1  1  1  1  1  1  1  1  1  
1  1  1  1  1  1  1  1  1  1  1  1  1  1  1  1  
1  1  1  1  1  1  1  1  1  1  1  1  1  1  1  1
 
1  1  1  1  1  1  1  1  1  1  1  1  1  1  1  1  
1  1  1  1  1  1  1  1  1  1  1  1  1  1  1  1  
1  1  1  1  1  1  1  1  1  1  1  1  1  1  1  1  
1  1  1  1  1  1  1  1  1  1  1  1  1  1  1  1  
1  1  1  1  1  1  1  1  1  1  1  1  1  1  1  1  
1  1  1  1  1  1  1  1  1  1  1  1  1  1  1  1  
4  5  16  16  16  94  17  18  1  1  1  1  17  18  1  1  
4  5  1  1  4  5  16  16  16  94  95  1  4  5  80  81  
1  1  1  1  1  1  1  1  1  1  1  1  1  1  1  1  
1  1  1  1  1  1  1  1  1  1  1  1  1  1  1  1  
1  1  1  1  1  1  1  1  1  1  1  1  1  1  1  1
 
1  1  1  1  1  1  1  1  1  1  1  1  1  1  1  1  
1  1  1  1  1  1  1  1  1  1  1  1  1  1  1  1  
1  1  1  1  1  1  1  1  1  1  1  1  1  1  1  1  
1  1  1  1  1  1  1  1  1  1  1  1  1  1  1  1  
1  1  1  1  1  1  1  1  1  1  1  1  1  1  1  1  
1  1  1  1  1  1  1  1  1  1  1  1  1  1  1  1  
4  18  16  16  16  16  1  1  1  1  1  1  4  18  1  1  
4  5  1  1  4  5  16  16  16  16  94  95  4  5  80  81  
1  1  1  1  1  1  1  1  1  1  1  1  1  1  1  1  
1  1  1  1  1  1  1  1  1  1  1  1  1  1  1  1  
1  1  1  1  1  1  1  1  1  1  1  1  1  1  1  1
 
1  1  1  1  1  1  1  1  1  1  1  1  1  1  1  1  
1  1  1  1  1  1  1  1  1  1  1  1  1  1  1  1  
1  1  1  1  1  1  1  1  1  1  1  1  1  1  1  1  
1  1  1  1  1  1  1  1  1  1  1  1  1  1  1  1  
1  1  1  1  1  1  1  1  1  1  1  1  1  1  1  1  
1  1  1  1  1  1  1  1  1  1  1  1  1  1  1  1  
17  18  16  16  16  16  38  96  1  1  1  1  17  18  1  1  
4  5  1  1  4  5  16  16  16  16  16  94  4  5  80  81  
1  1  1  1  1  1  1  1  1  1  1  1  1  1  1  1  
1  1  1  1  1  1  1  1  1  1  1  1  1  1  1  1  
1  1  1  1  1  1  1  1  1  1  1  1  1  1  1  1
 
1  1  1  1  1  1  1  1  1  1  1  1  1  1  1  1  
1  1  1  1  1  1  1  1  1  1  1  1  1  1  1  1  
1  1  1  1  1  1  1  1  1  1  1  1  1  1  1  1  
1  1  1  1  1  1  1  1  1  1  1  1  1  1  1  1  
1  1  1  1  1  1  1  1  1  1  1  1  1  1  1  1  
1  1  1  1  1  1  1  1  1  1  1  1  1  1  1  1  
1  1  1  1  1  1  1  1  1  1  1  1  1  1  1  1  
1  1  1  1  1  1  1  1  1  1  1  1  1  97  80  81  
1  1  1  1  1  1  1  1  1  1  1  1  1  1  1  1  
1  1  1  1  1  1  1  1  1  1  1  1  1  1  1  1  
1  1  1  1  1  1  1  1  1  1  1  1  1  1  1  1
 
1  1  1  1  1  1  1  1  1  1  1  1  1  1  1  1  
1  1  1  1  1  1  1  1  1  1  1  1  1  1  1  1  
1  1  1  1  1  1  1  1  1  1  1  1  1  1  1  1  
1  1  1  1  1  1  1  1  1  1  1  1  1  1  1  1  
1  1  1  1  1  1  1  1  1  1  1  1  1  1  1  1  
1  1  1  1  1  1  1  1  1  1  1  1  1  1  1  1  
38  39  98  99  98  99  38  39  100  101  98  99  38  39  1  1  
38  39  1  1  38  39  98  99  98  99  98  99  38  102  80  81  
1  1  1  1  1  1  1  1  1  1  1  1  1  1  1  1  
1  1  1  1  1  1  1  1  1  1  1  1  1  1  1  1  
1  1  1  1  1  1  1  1  1  1  1  1  1  1  1  1
 
1  1  1  1  1  1  1  1  1  1  1  1  1  1  1  1  
1  1  1  1  1  1  1  1  1  1  1  1  1  1  1  1  
1  1  1  1  1  1  1  1  1  1  1  1  1  1  1  1  
1  1  1  1  1  1  1  1  1  1  1  1  1  1  1  1  
1  1  1  1  1  1  1  1  1  1  1  1  1  1  1  1  
1  1  1  1  1  1  1  1  1  1  1  1  1  1  1  1  
4  18  1  1  1  1  4  18  103  104  105  105  4  5  1  106  
4  5  1  106  4  5  105  105  1  106  1  1  4  5  1  1  
1  1  1  1  1  1  1  1  1  1  1  1  1  1  1  1  
1  1  1  1  1  1  1  1  1  1  1  1  1  1  1  1  
1  1  1  1  1  1  1  1  1  1  1  1  1  1  1  1
 
1  1  1  1  1  1  1  1  1  1  1  1  1  1  1  1  
1  1  1  1  1  1  1  1  1  1  1  1  1  1  1  1  
1  1  1  1  1  1  1  1  1  1  1  1  1  1  1  1  
1  1  1  1  1  1  1  1  1  1  1  1  1  1  1  1  
1  1  1  1  1  1  1  1  1  1  1  1  1  1  1  1  
1  1  1  1  1  1  1  1  1  1  1  1  1  1  1  1  
17  18  1  1  1  1  17  18  1  1  105  105  4  5  107  108  
4  5  107  108  4  5  105  105  107  108  1  1  4  5  98  99  
1  1  1  1  1  1  1  1  1  1  1  1  1  1  1  1  
1  1  1  1  1  1  1  1  1  1  1  1  1  1  1  1  
1  1  1  1  1  1  1  1  1  1  1  1  1  1  1  1
 
1  1  1  1  1  1  1  1  1  1  1  1  1  1  1  1  
1  1  1  1  1  1  1  1  1  1  1  1  1  1  1  1  
1  1  1  1  1  1  1  1  1  1  1  1  1  1  1  1  
1  1  1  1  1  1  1  1  1  1  1  1  1  1  1  1  
1  1  1  1  1  1  1  1  1  1  1  1  1  1  1  1  
1  1  1  1  1  1  1  1  1  1  1  1  1  1  1  1  
109  110  109  110  109  110  109  110  109  110  109  110  109  110  109  110  
109  110  109  110  109  110  109  110  109  110  109  110  1  1  109  110  
1  1  1  1  1  1  1  1  1  1  1  1  1  1  1  1  
1  1  1  1  1  1  1  1  1  1  1  1  1  1  1  1  
1  1  1  1  1  1  1  1  1  1  1  1  1  1  1  1
 
1  1  1  1  1  1  1  1  1  1  1  1  1  1  1  1  
1  1  1  1  1  1  1  1  1  1  1  1  1  1  1  1  
1  1  1  1  1  1  1  1  1  1  1  1  1  1  1  1  
1  1  1  1  1  1  1  1  1  1  1  1  1  1  1  1  
1  1  1  1  1  1  1  1  1  1  1  1  1  1  1  1  
1  1  1  1  1  1  1  1  1  1  1  1  1  1  1  1  
111  112  111  112  111  112  111  112  111  112  111  112  111  112  111  112  
111  112  111  112  111  112  111  112  111  112  111  112  38  39  111  112  
1  1  1  1  1  1  1  1  1  1  1  1  1  1  1  1  
1  1  1  1  1  1  1  1  1  1  1  1  1  1  1  1  
1  1  1  1  1  1  1  1  1  1  1  1  1  1  1  1
